111111111
100000001
101P01E01
10000C001
101001001
100000001
111111111