111111
10E001
1C0P01
100001
100001
111111