1111111111111111111111111111111111
1PCE111111111111111111000000000001
1010111111111111111111000000000001
1010111111111111111111000000000001
1010111111110000000000000000000001
1000000000000111111111100000000001
1010111111111111111111000000000001
1010110000000000011100000000000001
1010100000000000111110000000000001
1010110000000000011000000000000001
1010111111111111111111000000000001
1010110000000000011100000000000001
1010100000000000111110000000000001
1010110000000000011000000000000001
1111111111111111111111111111111111