1111111
100C001
1EC1001

1000P01
1111111