1111111111111

10P00000C00E1
1111111111111