11111111111111111111
1000000CCC0000100001
10P0000C00000E000001
10111000011C10001001
11111111111111111111